Κλαση main:
Standardbuyers(): ορίζουμε εξαρχής κάποιος αγοραστές και τον ιδιοκτήτη του καταστήματος 
login()
register()

κλαση shopping cart:
viewcart(): ελέγχει τα προϊόντα που έχεις στο καλάθι
showcart(): εμφανίζει τα προϊόντα που έχεις στο καλάθι
CalculateArrivingTime(): υπολογίζει τον χρόνο παράδοσης 
checkout(): αγορά προιόντος
calculatenet(): υπολογίζει το συνολικό κόστος μαζί με Κούριερ εκπτώσεις 
couriercost(): υπολογίζει το κόστος του courier
category(): κοιτάει την κατηγορία του αγοραστή
clearcart(): αδειάζει το καλάθι

κλάση Pencil, Pen, Notebook, Paper
Pencil(),  Pen(),  Notebook(),  Paper() : χαρακτηριστικά 
getDetails(): τα συνολικά χαρακτηριστικά

Κλάση Owner:
Owner(): επιλογές που μπορεί να κάνει ο ιδιοκτήτης 

Κλάση eshop:
addNewItem(): προσθήκη προιόντος
removeItem(): αφαίρεση προϊόντος 
showItem(): εμφάνιση προιόντος 
addbuyer(): προσθήκη καινούριου αγοραστή
removebuyer(): αφαίρεση αγοραστή
updateitemstock(): ανανεώνει το απόθεμα των προϊόντων
checkstatus(): παίρνει την μέθοδο status() από την κλάση Buyer.

Κλάση Buyer:	
status(): εμφανίζει την κατάσταση των χρηστών(όνομα χρήστη, κατηγορία, ποσότητα διαφορετικών αντικειμένων.
choice(): Μια Switch case για το τι θέλει να κάνει ο αγοραστής
store(): δείχνει τα προϊόντα όλα μαζί 
bonusSetCategory(): ορίζει την κατηγορία του αγοραστή βάσει το συνολικό κόστος των αγορών του. 
